The Crux of the Biscuit
An Interactive Fiction by Mike Hutchinson
Release 1 / Serial number 160709 / Inform 7 build 6M62 (I6/v6.33 lib 6/12N) SD

Sitting Room
A gentle prod wakes you from your idle daydreaming.  There is a warming glow against your back, and you hear the crackle and snap of a slightly damn log burning in the grate behind you.  In front of your are two large unwashed feet.

One of them prods you a second time:   "Go on boy, get me slippers.  Get grandpa's slippers.  Off you go.  Bring them here.  Who's a good boy.  Get grandpa's slippers."

You can see an armchair (in which is an Old Man) here.

>look
Sitting Room
There is a gentle snoring.

You can see an armchair (in which is an Old Man) here.

>go
You'll have to say which compass direction to go in.

>south
Kitchen
This is the kitchen.

The bin smells great.

The damp patch on the floor below the sink less so.

>look bin
You see nothing special about the bin.

* * *

>look
Sitting Room
There is a gentle snoring.

You can see an armchair (in which is an Old Man) here.

>look old man
His face is a tapestry of wrinkles.  The skin looks like that of the apple you found in next door's bin yesterday.  From this angle, he is mostly feet.

>look feet
The skin in loose and hollow.  There are pieces of rusett fluff stuck to the bottom of the toes, and wedged under the toenails, which are discoloured and cracked.  Nevertheless, you are a great admirer of these feet, and of the gurgling face that even now looms closer and closer.

"Shoo boy! GET... SLIP...PERS..."

The door to the kitchen is South of you.  A staircase leading to the first floor lies to the East.

>south
Kitchen
This is the kitchen.  The bin smells great.  The damp patch on the floor below the sink less so. The sitting room is North.  West is an external door to the garden.

You can see a bin (closed), a sink and a cupboard (closed) here.

>west
The kitchen door is closed, and locked.

* * *

>look armchiar
You can't see any such thing.

>look armchair
You see nothing special about the armchair.

* * *

>look feet
The skin in loose and hollow.  There are pieces of rusett fluff stuck to the bottom of the toes, and wedged under the toenails, which are discoloured and cracked.  Nevertheless, you are a great admirer of these feet, and of the gurgling face that even now looms closer and closer.

"Shoo boy! GET... SLIP...PERS..."

The door to the kitchen is South of you.  A staircase leading to the first floor lies to the East.

>east
You can't go that way.

>south
Kitchen
This is the kitchen.  The bin smells great.  The damp patch on the floor below the sink less so.

You can see a bin and a sink here.

* * *

>look sink
There is a cupboard under the sink.

>look cupboard under sink
You can't see any such thing.

>look cupboard
You can't see any such thing.

* * *

>look feet
The skin in loose and hollow.  There are pieces of rusett fluff stuck to the bottom of the toes, and wedged under the toenails, which are discoloured and cracked.  Nevertheless, you are a great admirer of these feet, and of the gurgling face that even now looms closer and closer.

"Shoo boy! GET... SLIP...PERS..."

The door to the kitchen is South of you.  A staircase leading to the first floor lies to the East.

>easty
That's not a verb I recognise.

>east
Those stairs look like a lot of effort...

>south
Kitchen
This is the kitchen.  The bin smells great.  The damp patch on the floor below the sink less so. The sitting room is North.  West is an external door to the garden.

You can see a bin (closed), a sink and a cupboard (closed) here.

>south
You can't go that way.

>west
The kitchen door is closed, and locked.

>open cupboard
You open the cupboard.

>look cupboard
The cupboard is empty.

>look
Kitchen
This is the kitchen.   The sitting room is North.  West is an external door to the garden.

You can see a bin (closed), a sink and a cupboard (empty) here.

* * *

>look feet
The skin in loose and hollow.  There are pieces of rusett fluff stuck to the bottom of the toes, and wedged under the toenails, which are discoloured and cracked.  Nevertheless, you are a great admirer of these feet, and of the gurgling face that even now looms closer and closer.

"Shoo boy! GET... SLIP...PERS..."

The door to the kitchen is South of you.  A staircase leading to the first floor lies to the East.

>go south
Kitchen
This is the kitchen.  The bin smells great.  The damp patch on the floor below the sink less so. The sitting room is North.  West is an external door to the garden.

You can see a bin (closed), a sink and a cupboard (closed) here.

>open bin
The bin is nearly full.  On top of a newspaper splattered with mashed potato remnances is a filthy red tarten slipper.

>get bin
Taken.

>i
You are carrying:
  a bin (open)
    a slipper

>drop bin
Dropped.

>i
You are carrying nothing.

>open bin
That's already open.

>get slippers
You can't see any such thing.

>get slipper
(You grab the slipper in your mouth). The bin shuts with a PING!

>look
Kitchen
This is the kitchen.   The sitting room is North.  West is an external door to the garden.

You can see a bin (closed), a sink and a cupboard (closed) here.

>look sink
There is a cupboard under the sink.

>open cupboard
You open the cupboard.

* * *

>look cupboard
The cupboard is empty.

>look cupboard
The cupboard is empty.

>x cupboard
The cupboard is empty.

* * *

>look old man
His face is a tapestry of wrinkles.  The skin looks like that of the apple you found in next door's bin yesterday.

>look feet
The skin in loose and hollow.  There are pieces of rusett fluff stuck to the bottom of the toes, and wedged under the toenails, which are discoloured and cracked.  Nevertheless, you are a great admirer of these feet, and of the gurgling face that even now looms closer and closer.

* * *

>look old man
His face is a tapestry of wrinkles.  The skin looks like that of the apple you found in next door's bin yesterday.

>look old man's feet
The skin in loose and hollow.  There are pieces of rusett fluff stuck to the bottom of the toes, and wedged under the toenails, which are discoloured and cracked.  Nevertheless, you are a great admirer of these feet, and of the gurgling face that even now looms closer and closer.

 "Shoo boy! GET... SLIP...PERS..."

* * *

>look old man
His face is a tapestry of wrinkles.  The skin looks like that of the apple you found in next door's bin yesterday.

>look old mand's feet
You can't see any such thing.

>look old man's feet
You see nothing special about the Old man's feet.

* * *

>look old mand
You can't see any such thing.

>look old man
His face is a tapestry of wrinkles.  The skin looks like that of the apple you found in next door's bin yesterday.  From this angle, he is mostly feet.

>look feet
The skin in loose and hollow.  There are pieces of rusett fluff stuck to the bottom of the toes, and wedged under the toenails, which are discoloured and cracked.  Nevertheless, you are a great admirer of these feet, and of the gurgling face that even now looms closer and closer.

 "Shoo boy! GET... SLIP...PERS..."

>exits
That's not a verb I recognise.

* * *

>south
Kitchen
This is the kitchen.  The bin smells great.  The damp patch on the floor below the sink less so. The sitting room is North.  West is an external door to the garden.

You can see a bin (closed), a sink and a cupboard (closed) here.

>look sink
There is a cupboard under the sink.

>look cupboard
You can't see any such thing.

>open cupboard
You can't see any such thing.

* * *

>south
Kitchen
This is the kitchen.  The bin smells great.  The damp patch on the floor below the sink less so. The sitting room is North.  West is an external door to the garden.

You can see a bin (closed), a sink and a cupboard (closed) here.

>open bin
The bin is nearly full.  On top of a newspaper splattered with mashed potato remnances is a filthy red tarten slipper.

>get slipper
(You grab the slipper in your mouth). The bin shuts with a PING!

>north
Sitting Room
There is a gentle snoring.

You can see an armchair (in which is an Old Man) here.

>give slipper to old man
*** You have won ***

In that game you scored 0 out of a possible 0, in 5 turns.

Would you like to RESTART, RESTORE a saved game, QUIT or UNDO the last command?

* * *

>take feet
That seems to be a part of the Old Man.

>take old man
I don't suppose the Old Man would care for that.

>take armchair
That's fixed in place.

>smell feet
The feet smell awful.

>south
Kitchen
This is the kitchen.  The bin smells great.  The damp patch on the floor below the sink less so. The sitting room is North.  West is an external door to the garden.

You can see a bin (closed), a sink and a cupboard (closed) here.

>north
Sitting Room
There is a gentle snoring.

You can see an armchair (in which is an Old Man) here.

>south
Kitchen
This is the kitchen.   The sitting room is North.  West is an external door to the garden.

You can see a bin (closed), a sink and a cupboard (closed) here.

>look bin
It is a small bin with a pedal action that you long ago puzzled out.  It may have been silver once, but the numberless tea stains have left it resembling the ruddy bronze plate mail of some pertified dwarf.
There is a slipper on the top.

>open bin
The bin is nearly full.  On top of a newspaper splattered with mashed potato remnances is a filthy red tarten slipper.

>look bin
A browning pear core settles against a Fray Bentos pie tin.  It smells heavenly.
There is a slipper on the top.

>get slipper
(You grab the slipper in your mouth). The bin shuts with a PING!

>look slipper
An unspeakable object.  The front encrusted with mud from the flowerbeds outside; the back torn and flapping from teeth marks; the inside a grim dungeon of talc residue and foot slime.

>look
Kitchen
This is the kitchen.   The sitting room is North.  West is an external door to the garden.

You can see a bin (closed), a sink and a cupboard (closed) here.

>open bin
The bin is nearly full.  On top of a newspaper splattered with mashed potato remnances is a Fray Bentos pie tin.

* * *

>talk old man
That's not a verb I recognise.

>talk to the old man
That's not a verb I recognise.

>lick old man
That's not a verb I recognise.

>look old man
You see nothing special about the Old Man.

* * *

>x old man
You see nothing special about the Old Man.

>x feet
You see nothing special about the Old man's feet.